meow = [t]
meowmeow = [m]
meowmeowmeow = [o]
meowmeowmeowmeowmeow = [0]
meowmeowmeowmeownya = [9]
meowmeowmeownyanya = [8]
meowmeowmeownyanyanya = [:]
meowmeownya = [g]
meowmeownyameow = [q]
meowmeownyanya = [z]
meowmeownyanyameowmeow = [,]
meownya = [n]
meownyameow = [k]
meownyameowmeow = [y]
meownyameownya = [c]
meownyanya = [d]
meownyanyameow = [x]
meownyanyanya = [b]
meownyanyanyanyameow = [-]
nya = [e]
nyameow = [a]
nyameowmeow = [w]
nyameowmeowmeow = [j]
nyameowmeowmeowmeow = [1]
nyameowmeowmeowmeownya = [']
nyameowmeownya = [p]
nyameownya = [r]
nyameownyameownyameow = [.]
nyameownyanya = [l]
nyanya = [i]
nyanyameow = [u]
nyanyameowmeowmeow = [2]
nyanyameowmeownyameow = [_]
nyanyameowmeownyanya = [?]
nyanyameownya = [f]
nyanyanya = [s]
nyanyanyameow = [v]
nyanyanyameowmeow = [3]
nyanyanyanya = [h]
nyanyanyanyameow = [4]
nyanyanyanyanya = [5]
purr = [ ]
